30  50
000 000 000 000 000 000 000 000 000 000 000 000 000 000 000 000 000 000 000 000 000 000 000 000 000 000 000 000 000 000
000 000 000 000 000 000 000 000 000 000 000 000 000 000 000 000 000 000 000 000 000 000 000 000 000 000 000 000 000 000
000 000 000 000 000 000 000 000 000 000 000 000 000 000 000 000 000 000 000 000 000 000 000 000 000 000 000 000 000 000
000 000 000 000 000 000 000 000 000 000 000 000 000 000 000 000 000 000 000 000 000 000 000 000 000 000 000 000 000 000
000 000 000 000 000 000 000 000 000 000 000 000 000 000 000 000 000 000 000 000 000 000 000 000 000 000 000 000 000 000
000 000 000 000 000 000 000 000 000 000 000 000 000 000 000 000 000 000 000 000 000 000 000 000 000 000 000 000 000 000
000 000 000 000 000 000 000 000 000 000 000 000 000 000 000 000 000 000 000 000 000 000 000 000 000 000 000 000 000 000
000 000 000 000 000 000 000 000 000 000 000 000 000 000 000 000 000 000 000 000 000 000 000 000 000 000 000 000 000 000
000 000 000 000 000 000 000 000 000 000 000 000 000 000 000 000 000 000 000 000 000 000 000 000 000 000 000 000 000 000
000 000 000 000 000 000 000 000 000 000 000 000 000 000 000 000 000 000 000 000 000 000 000 000 000 000 000 000 000 000
000 000 000 000 000 000 000 000 000 000 000 000 000 000 000 000 000 000 000 000 000 000 000 000 000 000 000 000 000 000
000 000 000 000 000 000 000 000 000 000 000 000 000 000 000 000 000 000 000 000 000 000 000 000 000 000 000 000 000 000
000 000 000 000 000 000 000 000 000 000 000 000 000 000 000 000 000 000 000 000 000 000 000 000 000 000 000 000 000 000
000 000 000 000 000 000 000 000 000 000 000 000 000 000 000 000 000 000 000 000 000 000 000 000 000 000 000 000 000 000
000 000 000 000 000 000 000 000 000 000 000 000 000 000 000 000 000 000 000 000 000 000 000 000 000 000 000 000 000 000
000 000 000 000 000 000 000 000 000 000 000 000 000 000 000 000 000 000 000 000 000 000 000 000 000 000 000 000 000 000
000 000 000 000 000 000 000 000 000 000 000 000 000 000 000 000 000 000 000 000 000 000 000 000 000 000 000 000 000 000
000 000 000 000 000 000 000 000 000 000 000 000 000 000 000 000 000 000 000 000 000 000 000 000 000 000 000 000 000 000
000 000 000 000 000 000 000 000 000 000 000 000 000 000 000 000 000 000 000 000 000 000 000 000 000 000 000 000 000 000
000 000 000 000 000 000 000 000 000 000 000 000 000 000 000 000 000 000 000 000 000 000 000 000 000 000 000 000 000 000
000 000 000 000 000 000 000 000 000 000 000 000 000 000 000 000 000 000 000 000 000 000 000 000 000 000 000 000 000 000
000 000 000 000 000 000 000 000 000 000 000 000 000 000 000 000 000 000 000 000 000 000 000 000 000 000 000 000 000 000
000 000 000 000 000 000 000 000 000 000 000 000 000 000 000 000 000 000 000 000 000 000 000 000 000 000 000 000 000 000
000 000 000 000 000 000 000 000 000 000 000 000 000 000 000 000 000 000 000 000 000 000 000 000 000 000 000 000 000 000
000 000 000 000 000 000 000 000 000 000 000 000 000 000 000 000 000 000 000 000 000 000 007 004 004 004 004 004 006 000
000 000 000 000 000 000 000 000 000 000 000 000 000 000 000 000 000 000 000 000 000 000 003 001 001 001 001 001 002 000
000 000 000 000 000 000 000 000 000 000 000 000 000 000 000 000 000 000 000 000 000 000 003 001 001 001 001 001 002 000
000 000 000 000 000 000 000 000 000 000 000 000 000 000 000 000 000 000 000 000 000 000 003 001 001 001 001 001 002 000
000 000 000 000 000 000 000 000 000 000 000 000 000 000 000 000 000 000 000 000 000 000 003 001 001 001 001 001 002 000
000 000 000 000 000 000 000 000 000 000 000 000 000 000 000 000 000 000 000 000 000 005 012 001 001 001 001 001 002 000
000 000 000 000 000 000 000 000 000 000 000 000 000 000 000 000 000 000 000 000 014 001 001 001 001 001 001 001 002 000
000 000 000 000 000 000 000 000 000 000 000 000 000 000 000 000 000 000 003 001 002 004 010 001 001 001 001 001 002 000
000 000 000 000 000 000 000 000 000 000 000 000 000 000 000 000 000 000 003 001 002 000 003 001 001 001 001 001 002 000
000 000 000 000 000 000 000 000 000 000 000 000 000 000 000 000 000 000 003 001 002 000 003 001 001 001 001 001 002 000
000 000 000 000 000 000 000 000 000 000 000 000 000 000 000 000 000 000 003 001 002 000 003 001 001 001 001 001 002 000
000 000 000 000 000 000 000 000 000 000 000 000 000 000 000 000 000 000 003 001 002 000 003 001 001 001 001 001 002 000
000 000 000 000 000 000 000 000 000 000 000 000 000 000 000 000 000 000 003 001 002 000 009 005 005 005 005 005 008 000
000 000 000 000 000 000 000 000 000 000 000 000 000 000 000 000 000 000 003 001 002 000 000 000 000 000 000 000 000 000
000 000 000 000 000 000 000 000 000 000 000 000 000 000 000 007 004 004 004 017 004 004 004 006 000 000 000 000 000 000
000 000 000 000 000 000 000 000 000 000 000 000 000 000 000 003 001 001 001 001 001 001 001 002 000 000 000 000 000 000
000 000 000 000 000 000 000 000 000 000 000 000 000 000 000 003 001 001 001 001 001 001 001 002 000 000 000 000 000 000
000 000 000 000 000 000 000 000 000 000 000 000 000 000 000 003 001 001 001 001 001 001 001 002 000 000 000 000 000 000
000 000 000 000 000 000 000 000 000 000 000 000 000 000 000 003 001 001 001 001 001 001 001 002 000 000 000 000 000 000
000 000 000 000 000 000 000 000 000 000 000 000 000 000 000 003 001 001 001 001 001 001 001 002 000 000 000 000 000 000
000 000 000 000 000 000 000 000 000 000 000 000 000 000 000 003 001 001 001 001 001 001 001 002 000 000 000 000 000 000
000 000 000 000 000 000 000 000 000 000 000 000 000 000 000 003 001 001 001 001 001 001 001 002 000 000 000 000 000 000
000 000 000 000 000 000 000 000 000 000 000 000 000 000 000 003 001 001 001 001 001 001 001 002 000 000 000 000 000 000
000 000 000 000 000 000 000 000 000 000 000 000 000 000 000 003 001 001 001 018 001 001 001 002 000 000 000 000 000 000
000 000 000 000 000 000 000 000 000 000 000 000 000 000 000 003 001 001 001 019 001 001 001 002 000 000 000 000 000 000
000 000 000 000 000 000 000 000 000 000 000 000 000 000 000 009 005 005 005 005 005 005 005 008 000 000 000 000 000 000