30  50
000 000 000 000 000 000 000 000 000 000 000 000 000 000 000 000 000 000 000 000 000 000 000 000 000 000 000 000 000 000
000 000 000 000 000 000 000 000 000 000 000 000 000 000 000 000 000 000 000 000 000 000 000 000 000 000 000 000 000 000
000 000 000 000 000 000 000 000 000 000 000 000 000 000 000 000 000 000 000 000 000 000 000 000 000 000 000 000 000 000
000 000 000 000 000 000 000 000 000 000 000 000 000 000 000 000 000 000 000 000 000 000 000 000 000 000 000 000 000 000
000 000 000 000 000 000 000 000 000 000 000 000 000 000 000 000 000 000 000 000 000 000 000 000 000 000 000 000 000 000
000 000 000 000 000 000 000 000 000 000 000 000 000 000 000 000 000 000 000 000 000 000 000 000 000 000 000 000 000 000
000 000 000 000 000 000 000 000 000 000 000 000 000 000 000 000 000 000 000 000 000 000 000 000 000 000 000 000 000 000
000 000 000 000 000 000 000 000 000 000 000 000 000 000 000 000 000 000 000 000 000 000 000 000 000 000 000 000 000 000
000 000 000 000 000 000 000 000 000 000 000 000 000 000 000 000 000 000 000 000 000 000 000 000 000 000 000 000 000 000
000 000 000 000 000 000 000 000 000 000 000 000 000 000 000 000 000 000 000 000 000 000 000 000 000 000 000 000 000 000
000 000 000 000 000 000 000 000 000 000 000 000 000 000 000 000 000 000 000 000 000 000 000 000 000 000 000 000 000 000
000 000 000 000 000 000 000 000 000 000 000 000 000 000 000 000 000 000 000 000 000 000 000 000 000 000 000 000 000 000
000 000 000 000 000 000 000 000 000 000 000 000 000 000 000 000 000 000 000 000 000 000 000 000 000 000 000 000 000 000
000 000 000 000 000 000 000 000 000 000 000 000 000 000 000 000 000 000 000 000 000 000 000 000 000 000 000 000 000 000
000 000 000 000 000 000 000 000 000 000 000 000 000 000 000 000 000 000 000 000 000 000 000 000 000 000 000 000 000 000
000 000 000 000 000 000 000 000 000 000 000 000 000 000 000 000 000 000 000 000 000 000 000 000 000 000 000 000 000 000
000 000 000 000 000 000 000 000 000 000 000 000 000 000 000 000 000 000 000 000 000 000 000 000 000 000 000 000 000 000
000 000 000 000 000 000 000 000 000 000 000 000 000 000 000 000 000 000 000 000 000 000 000 000 000 000 000 000 000 000
000 000 000 000 000 000 000 000 000 000 000 000 000 000 000 000 000 000 000 000 000 000 000 000 000 000 000 000 000 000
000 000 000 000 000 000 000 000 000 000 000 000 000 000 000 000 000 000 000 000 000 000 000 000 000 000 000 000 000 000
000 000 000 000 000 000 000 000 000 000 000 000 000 000 000 000 000 000 000 000 000 000 000 000 000 000 000 000 000 000
000 000 000 000 000 000 000 000 000 000 000 000 000 000 000 000 000 000 000 000 000 000 000 000 000 000 000 000 000 000
000 000 000 000 000 000 000 000 000 000 000 000 000 000 000 000 000 000 000 000 000 000 000 000 000 000 000 000 000 000
000 000 000 000 000 000 000 000 000 000 000 000 000 000 000 000 000 000 000 000 000 000 000 000 000 000 000 000 000 000
000 000 000 000 000 000 000 000 000 000 000 000 000 000 000 000 000 000 000 000 000 000 000 000 000 000 000 000 000 000
000 000 000 000 000 000 000 000 000 000 000 000 000 000 000 000 000 000 000 000 000 000 000 000 000 000 000 000 000 000
007 004 004 004 004 004 004 004 006 000 000 000 000 000 000 000 000 000 000 000 000 000 000 000 000 000 000 000 000 000 
003 001 001 001 001 001 001 001 002 000 000 000 000 000 000 000 000 000 000 000 000 000 000 007 004 004 004 004 004 006 
003 001 001 001 001 001 001 001 002 000 000 000 000 007 004 006 000 000 000 000 000 000 000 003 001 001 001 001 001 002 
003 001 001 001 001 001 001 001 002 004 004 004 004 012 027 013 004 004 004 004 006 000 003 001 001 001 001 001 002 000
003 001 001 001 001 036 001 001 015 001 001 001 001 001 001 001 001 001 001 001 002 000 003 001 001 036 001 001 002 000
003 001 001 001 001 001 001 001 002 005 005 005 005 005 005 005 005 005 010 001 002 000 003 001 001 001 001 001 002 000
003 001 001 001 001 001 001 001 002 000 000 000 000 000 000 000 000 000 003 001 002 004 012 001 001 001 001 001 002 000
003 001 001 001 001 001 001 001 002 000 000 000 000 000 000 000 000 000 003 001 014 001 001 001 001 001 001 021 002 000
009 005 005 005 005 005 005 005 008 000 000 000 000 000 000 000 000 000 003 001 002 005 010 001 001 001 001 001 002 000
000 000 000 000 000 000 000 000 000 000 000 000 000 000 000 000 000 000 003 001 002 000 003 001 001 001 001 001 002 000
000 000 000 000 000 000 000 000 000 000 000 000 000 000 000 000 000 000 003 001 002 000 003 001 001 036 001 001 002 000
000 000 000 000 000 000 000 000 000 000 000 000 000 000 000 000 000 000 003 001 002 000 003 001 001 001 001 001 002 000
000 000 000 000 000 000 000 000 000 000 000 000 000 000 000 000 000 000 003 001 002 000 003 001 001 001 001 001 002 000
000 000 000 000 000 000 000 000 000 000 000 000 000 000 000 000 000 000 003 001 002 000 009 005 005 005 005 005 008 000
000 000 000 000 000 000 000 000 000 000 000 000 000 000 000 000 000 000 003 001 002 000 000 000 000 000 000 000 000 000
000 000 000 000 000 000 000 000 000 000 000 000 000 000 000 007 004 004 004 017 004 004 004 006 000 000 000 000 000 000
000 000 000 000 000 000 000 000 000 000 000 000 000 000 000 003 001 001 001 001 001 001 001 002 000 000 000 000 000 000
000 000 000 000 000 000 000 000 000 000 000 000 000 000 000 003 001 001 001 001 001 001 001 002 000 000 000 000 000 000
000 000 000 000 000 000 000 000 000 000 000 000 000 000 000 003 001 001 001 001 001 001 001 002 000 000 000 000 000 000
000 000 000 000 000 000 000 000 000 000 000 000 000 000 000 003 001 001 001 001 001 001 001 002 000 000 000 000 000 000
000 000 000 000 000 000 000 000 000 000 000 000 000 000 000 003 001 001 001 001 001 001 001 002 000 000 000 000 000 000
000 000 000 000 000 000 000 000 000 000 000 000 000 000 000 003 001 001 001 018 001 001 001 002 000 000 000 000 000 000
000 000 000 000 000 000 000 000 000 000 000 000 000 000 000 003 001 001 001 019 001 001 001 002 000 000 000 000 000 000
000 000 000 000 000 000 000 000 000 000 000 000 000 000 000 009 005 005 005 005 005 005 005 008 000 000 000 000 000 000